1111111111
1I100P0001
1100011101
10I00100E1
1111111111