11111111
10001011
1PI00111
100000E1
11111111