11111111111111
1P00000I0000E1
100001000000I1
11011111000111
1000I0000II111
11111111111111