11111111
10000E11
1PI00111
10000001
11111111