111110
10I010
10E010
1P0010
111110