1111111111
10000P0001
10000100I1
10I0010001
1111111111