1111111111
10000P01E1
1000010011
10I0010001
1111111111