1111111111
10000P0001
10E0010001
1000010001
1111111111