1111111111
1000000001
10E00100I1
10I0010001
1111111111