1111111111
10P00P0001
10E00100I1
10I0010001
1111111111