11111111111111
1000000I0000E1
100E00000000I1
11111111111111